{
  "w": 10,
  "h": 8,
  "tilesets": [
    {"min":0,"max":28,"url":"/sprites/maps/spriteSheets/tiletest.json"}
  ],
  "map": [
    [22, 22, 22, 22, 25, 25, 22, 22, 22, 22],
    [22, 22, 22, 22, 25, 25, 22, 22, 22, 22],
    [22, 22, 22, 22, 25, 25, 22, 22, 22, 22],
    [22, 25, 25, 25, 25, 25, 22, 22, 22, 22],
    [22, 25, 25, 25, 25, 25, 22, 22, 22, 22],
    [22, 25, 25, 22, 22, 22, 22, 22, 22, 22],
    [22, 25, 25, 22, 22, 22, 22, 22, 22, 22],
    [22, 25, 25, 22, 22, 22, 22, 22, 22, 22]
  ]
}