{
  "w": 64,
  "h": 64,
  "tilesets": [
    {"min": 0, "max": 99, "url": "/sprites/maps/spriteSheets/tiletest.json"},
    {"min": 100, "max": 199, "url": "/sprites/maps/spriteSheets/tiletestTwo.json"}
  ],
  "map": [
    [0, 1, 2, 3, 4, 5, 0, 1, 2, 3],
    [6, 7, 8, 9,10,11, 6, 7, 8, 9],
    [12,13,14,15,16,17,12,13,14,15],
    [18,19,20,21,22,23,18,19,20,21],
    [24,25,26,27,28,29,24,25,26,27],
    [121, 1, 2, 3, 4, 5, 0, 1, 2, 3],
    [6, 7, 8, 9,10,11, 6, 7, 8, 9],
    [12,13,14,15,16,17,12,13,14,15]
  ]
}
